静	jìng
碧	bì
璃	lí
墙	qiáng
撇	piě
嘉	jiā
摧	cuī
慕	mù
暮	mù
蔑	miè
模	mó
榴	liú
榜	bǎng
蜘	zhī
锹	qiāo
舞	wǔ
算	suàn
膀	bǎng
馒	mán
豪	háo
腐	fǔ
竭	jié
精	jīng
熔	róng
漫	màn
漏	lòu
赛	sài
谱	pǔ
熊	xióng
缩	suō
截	jié
誓	shì
境	jìng
摘	zhāi
摔	shuāi
聚	jù
蔽	bì
愿	yuàn
需	xū
弊	bì
蜻	qīng
蜡	là
蝇	yíng
赚	zhuàn
锻	duàn
稳	wěn
膜	mó
鲜	xiān
裹	guǒ
膏	gāo
瘦	shòu
端	duān
歉	qiàn
漆	qī
滴	dī
慢	màn
察	chá
嫩	nèn
凳	dèng
榨	zhà
歌	gē
遭	zāo
酷	kù
酿	niàng
酸	suān
磁	cí
裳	shang
颗	kē
嗽	sòu
箩	luó
管	guǎn
僚	liáo
鼻	bí
魄	pò
貌	mào
膊	bó
疑	yí
敲	qiāo
遮	zhē
辣	là
旗	qí
熄	xī
漂	piāo
演	yǎn
寨	zhài
蜜	mì
翠	cuì
骡	luó