慧	huì
撕	sī
撒	sā
趣	qù
趟	tàng
撑	chēng
播	bō
撞	zhuàng
撤	chè
增	zēng
聪	cōng
鞋	xié
题	tí
瞎	xiā
踢	tī
踩	cǎi
德	dé
膛	táng
颜	yán
遵	zūn
懂	dǒng
劈	pī
蕉	jiāo
蔬	shū
横	héng
槽	cáo
樱	yīng
橡	xiàng
飘	piāo
醋	cù
醉	zuì
震	zhèn
霉	méi
瞒	mán
暴	bào
影	yǐng
踏	tà
踪	zōng
艘	sōu
熟	shú
毅	yì
潜	qián
额	é
蝶	dié
蝴	hú
嘱	zhǔ
墨	mò
镇	zhèn
靠	kào
稻	dào
黎	lí
稿	gǎo
稼	jià
箱	xiāng
箭	jiàn
篇	piān
僵	jiāng
躺	tǎng
僻	pì
膝	xī
摩	mó
糊	hú
潮	cháo
慰	wèi